11111111111
1C0000E0001
10P001C1001
10000010C01
11111111111