111111111111111111111111
1E000000001P1000000000C1
100000011000001111100001
100001110000110000100001
100011000000000001100001
100011111000000110000001
1C0000011000001100000001
1000000110000111111000C1
111111111111111111111111